NO ./textures/pillar.xpm
SO ./textures/mossy.xpm
WE ./textures/redbrick.xpm
EA ./textures/wood.xpm
F 124,120,100
C 106,175,255

            

        1111111111111111111111111
        1000000000110000000000001
        101100000111000000S000001
        10010000000000000000000011111111
111111111011000001110000000001001
10000000001100000111011111111111
11110000000000000000000000001
1100000000000001110000000001
1100000011010101 100000010001
10000000000000011100000000001
10000000000000001101010010001
1100000111010101111101111000111
11110111 1110101 101111010001
11111111 1111111 111111111111
