NO /home/jaehukim/work/4/Cub3D/textures/redbrick.xpm
SO /home/jaehukim/work/4/Cub3D/textures/bluestone.xpm
WE /home/jaehukim/work/4/Cub3D/textures/wood.xpm
EA /home/jaehukim/work/4/Cub3D/textures/purplestone.xpm
F 220,100,0
C 225,30,0
111111111
100S00001
100000011
111111111
