NO ./textures/greystone.xpm
SO ./textures/mossy.xpm
WE ./textures/redbrick.xpm
EA ./textures/wood.xpm
F 124,120,119
C 106,175,230
1111111111111111111111111
1000000000110000000000001
1011000001110000000000001
100100000000000000000000111111111
111111111011000001110000000001001
100000000011000001110111111111111
11110000000000000000000000001
11000000000000011100000000001
1100000011010101 100000010001
10000000000000011100000000001
10000000000000001101010010001
11000001110101011111011110N0111
11110111 1110101 101111010001
11111111 1111111 111111111111
